1111111111111
10010CX0000C1
1000000011X01
1PX011E000C01
1111111111111