1111111111111
10010C00000C1
1000000011001
1P0011E000C01
1111111111111