1111111111111
1PC0000X000C1
1110111111111
10000000000E1
1111111111111