1111111111111
1PCCCC000CCC1
111C111111111
100X00X000XE1
1111111111111