1111111111111
10000C0E00001
100C00000X001
1CCCC0000XP01
1111111111111