1111111111111
1P00E100000C1
1111111111111