1111111111111
10000X0000001
1P0E0000000C1
1111110111111
100CCCCCCCCC1
1111111111111