1111111111111
1000000000001
1P0E0000000C1
1111110111111
100CCCCCCCCC1
1111111111111