11111111111111111111111111111
1PCCCCCCCCCCCCCCCCCCCCCCCCCC1
111C1111111111111111111111111
1X0X0X0X0X0X0X0X0X0X0X0X0X0X1
10X0X0X0X0X0X0X0X0X0X0X0X0X01
1X0X0X0X0X0X0X0X0X0X0X0X0X0X1
10X0X0X0X0X0X0X0X0X0X0X0X0X01
1X0X0X0X0X0X0X0X0X0X0X0X0X0X1
10X0X0X0X0X0X0X0X0X0X0X0X0X01
1X0X0X0X0X0X0X0X0X0X0X0X0X0X1
10X0X0X0X0X0X0X0X0X0X0X0X0X01
1X0X0X0X0X0X0X0X0X0X0X0X0X0X1
10X0X0X0X0X0X0X0X0X0X0X0X0X01
1X0X0X0X0X0X0X0X0X0X0X0X0X0X1
10X0X0X0X0X0X0X0X0X0X0X0X0XE1
11111111111111111111111111111